Selfish - Generous
Incurious - Curious
Secular - Spiritual
Pessimistic - Optimistic
Gullible - Critical
Vengeful - Forgiving
Lazy - Ambitious
Introverted - Extroverted
Serious - Playful
Stubborn - Flexible
Impulsive - Thoughtful
Dysregulated - Composed
Authoritarian - Libertarian
Conservative - Progressive
Apolitical - Activist
Misogynist - Egalitarian
Racist - Inclusive
Anxious - Calm
Vain - Humble
Violent - Peaceful
Unkind - Kind
Sensitive - Robust
Unhealthy - Healthy
Traditional - Contemporary
Asexual - Hypersexual
Competitive - Collaborative
Individualist - Collectivist
Cold - Loving
Difficult Childhood - Stable Childhood
Teenager - Centenarian
Destitute - Wealthy